+-+-+-+-+-+-+-+-+-+-+-+-+-+-+-+
S |       |   |     |     |   |
+ +-+-+ + + + + +-+ + + + +-+ +
| |     |   | | |   | | | |   |
+ + +-+-+-+-+ + + +-+-+ + + + +
|   |         | |       | | | |
+-+-+ +-+-+-+-+ +-+-+-+-+ + + +
|     |           |   |     | |
+ +-+-+ +-+-+-+ + +-+ + +-+-+ +
| |   |   |     |     | |     |
+ + + +-+ + +-+-+-+-+-+-+ +-+ +
|   | |   |   |   |         | |
+ +-+ + +-+-+ +-+ + +-+-+ + + +
| |     |   |     |     | | | |
+ +-+-+ + + +-+-+-+-+-+ + + +-+
|   | |   | |     |     | |   |
+-+ + +-+-+-+ +-+ + +-+-+ +-+ +
| |   |   |   | |   |   |   | |
+ + +-+ + + +-+ +-+-+ + +-+ +-+
| | |   | |   |   |   | |     |
+ + + +-+ +-+ +-+ + +-+ +-+-+ +
|     | |   |     |   |     | |
+-+ +-+ +-+ +-+-+-+-+ +-+-+ + +
|   | | |   |   |   |   | |   |
+ +-+ + + +-+ +-+ + +-+ + +-+ +
|   | |   | |     |   |   |   |
+-+ + +-+-+ +-+-+ +-+ +-+-+ +-+
| |         |     | |         |
+ +-+ +-+-+-+ + +-+ +-+-+-+-+ +
|     |       |     |         E
+-+-+-+-+-+-+-+-+-+-+-+-+-+-+-+