+-+-+-+-+-+-+-+-+-+-+-+-+-+-+-+
S |     |   |           |     |
+ + +-+ + + + +-+-+-+-+ + +-+ +
|   |   | |   |       | | |   |
+-+-+ + + +-+-+ +-+-+-+ + + +-+
|   | |   |     | |     | |   |
+ + + +-+-+ +-+-+ + +-+-+-+-+ +
| | | |   |   |   |   |     | |
+-+ +-+ + +-+ + +-+-+ + +-+ + +
|   |   |     |   |   | |   | |
+ +-+ +-+ + +-+-+ + +-+ +-+ + +
|     |   |       | | |   | | |
+ +-+-+ +-+-+-+-+-+ + +-+ + + +
| |   |       |   |     | |   |
+ + + +-+ + + + + +-+-+ + +-+ +
| | |   | | |   |   |     |   |
+ + +-+-+ +-+-+-+ +-+ +-+-+ +-+
| |   |   |     |     |   | | |
+ +-+ + +-+ +-+-+-+-+-+ + + + +
|   |   |               |   | |
+-+-+-+ + +-+-+-+-+-+-+-+-+-+ +
|       | |   |               |
+ +-+-+-+ + + + +-+-+-+ +-+-+-+
|       |   |   |       |     |
+-+-+-+ +-+-+-+-+ +-+-+-+ +-+ +
|     | |       |     |   | | |
+-+-+ + + +-+-+ +-+-+ + +-+ + +
|   |   |   |   |     | | |   |
+ + +-+ + + +-+-+ + +-+ + +-+ +
| |     | |       |     |     E
+-+-+-+-+-+-+-+-+-+-+-+-+-+-+-+