+-+-+-+-+-+-+-+-+-+-+-+-+-+-+-+
S       |     | |     |   |   |
+-+ + +-+ + + + + +-+ + + + + +
| | |     | |   |   | | | | | |
+ + +-+-+-+ +-+-+-+ + + + + + +
| |       |   |     | | |   | |
+ +-+-+-+ +-+ + + +-+ + +-+-+ +
|           | | |   | | |     |
+-+-+-+ +-+-+ + + +-+ + +-+-+-+
|     | |   |   | |   |       |
+ +-+ + +-+ +-+-+ + +-+-+ +-+ +
|   | |     |     |       | | |
+-+ + +-+-+-+-+-+-+-+ +-+-+ + +
|   | |               |     | |
+ +-+-+ +-+-+-+-+-+-+-+ +-+-+ +
|       |       |     |       |
+ +-+-+ +-+-+ +-+ +-+ +-+ +-+-+
| |   | |   | |     |   |   | |
+ + + + + + + + +-+-+-+ + + + +
| | | |   | | | |   | |   |   |
+ +-+ + +-+ + + + + + +-+ +-+-+
|     | | |   | | |     | |   |
+-+ +-+ + +-+-+ + +-+-+ + + + +
|   |   | |     | |   |   | | |
+ +-+ +-+ + +-+-+ + + +-+-+ + +
|   |     | |   |   |   |   | |
+-+ +-+-+-+ + + +-+-+-+ + +-+ +
| | | |     | |   |     | |   |
+ + + + +-+-+ +-+ + + +-+ + +-+
|   |   |       |   |     |   E
+-+-+-+-+-+-+-+-+-+-+-+-+-+-+-+