+-+-+-+-+-+-+-+-+-+-+-+-+-+-+-+
S |     |       |   |   |     |
+ + +-+ +-+-+-+ +-+ + + + +-+ +
|   |   |       |   | |     | |
+-+-+ +-+ +-+-+-+ +-+ + +-+-+ +
| |   |     |   | |   |     | |
+ + +-+ + + + + + +-+-+-+-+ +-+
|   |   | | | | | |       |   |
+ +-+-+-+ + + +-+ + +-+-+ + + +
| |   |   |   |   | |       | |
+ + + + + +-+-+ +-+-+ +-+-+-+ +
| | | | |     |     |       | |
+ + + +-+-+-+ +-+-+ +-+-+-+ +-+
| | |       |     |   |       |
+ + +-+-+-+ +-+-+ +-+ + + +-+ +
| |   |   |     |   | | |   | |
+ +-+ + + +-+-+ +-+ + + +-+ +-+
|   | | | |     |   |   |     |
+-+ + + + + +-+-+ +-+-+-+-+-+ +
|   |   | | |         |   | | |
+ +-+-+-+-+ + +-+ +-+ + + + + +
| |   | |   |   |   |   |   | |
+ + + + + +-+-+ +-+ +-+-+-+ + +
|   | |       |   |   |   | | |
+-+-+ +-+ +-+ +-+ + + + + +-+ +
|       | |       | |   |     |
+ +-+-+ + + + +-+-+-+-+-+-+-+-+
|   |   | | |   |   |       | |
+-+ + +-+ + +-+-+ + + +-+-+ + +
|   |     |       |   |       E
+-+-+-+-+-+-+-+-+-+-+-+-+-+-+-+