+-+-+-+-+-+-+-+-+-+-+-+-+-+-+-+
S   |   |     |   |     |   | |
+ + + + + +-+ +-+ + +-+-+ + + +
| | | |   | | |   |       |   |
+ + +-+ +-+ + + +-+-+-+-+-+ +-+
| |     |     | |   |   |     |
+ +-+-+-+-+-+-+ + + + + +-+ + +
|   |     |   | | |   |     | |
+-+ +-+-+ +-+ + + +-+ +-+-+-+ +
|   |             |   |   |   |
+ +-+ +-+-+-+-+ +-+ +-+ + +-+-+
|     |   |       |   | |   | |
+-+-+ + +-+ + +-+-+-+ + +-+ + +
|   | |     |   |   |   | | | |
+ + + +-+-+-+-+ + + +-+-+ + + +
| | |     |   | | |     |     |
+ +-+ +-+ + + + + +-+-+ +-+ +-+
|   |   | | | | | |   |   |   |
+-+ +-+ +-+ +-+ + +-+ +-+ +-+ +
|   |   |   |   | |     |   | |
+ +-+ +-+ +-+ +-+-+ + +-+-+ + +
|   | |   |   |     |     | | |
+ +-+ + +-+ +-+ +-+-+ +-+ + +-+
|     |   |   | |   |   | |   |
+ + +-+ + +-+ + +-+ +-+-+ +-+ +
| |   | |     |   |     | |   |
+-+-+ +-+-+-+-+-+ +-+-+ + + +-+
|     |   |       | |   | |   |
+ + +-+ + + +-+ +-+ + + + +-+ +
| |     |   |   |     |       E
+-+-+-+-+-+-+-+-+-+-+-+-+-+-+-+