+-+-+-+-+-+-+-+-+-+-+-+-+-+-+-+
S       |   |   |   |   |     |
+-+ +-+-+ + + + + + +-+ + +-+ +
|   |   | |   |   |   | | | | |
+ +-+ + + +-+-+-+-+-+ + + + + +
| |   |   |     |   |   | |   |
+ + + +-+-+ + +-+ + +-+-+ +-+-+
| | |     | |     | |   | |   |
+ +-+ +-+ + +-+-+-+ + + + + +-+
| |   |   |     |     |   |   |
+ + +-+-+ +-+-+ + +-+-+-+-+ + +
|   |   |   |   |     |     | |
+-+-+ + +-+ + +-+-+-+ +-+-+-+ +
|     | | |   |           |   |
+ +-+-+ + +-+-+ +-+-+ +-+ + +-+
|   | |     |   |     |   |   |
+-+ + +-+-+ + +-+ +-+-+ +-+-+ +
| |   |   | | | |     | |     |
+ + +-+ + + + + +-+-+ + + + + +
|   |   | | | |       |   | | |
+ +-+ +-+ + + +-+-+-+-+-+-+-+ +
|   |   | |   |               |
+-+ +-+ + +-+-+-+-+-+-+-+-+-+ +
| | |   |   |   | |   |   |   |
+ + + +-+ + +-+ + + + + + +-+ +
| |     | |     |   |   |   | |
+ +-+-+-+ + +-+-+-+-+-+-+-+ + +
|     |   |           |     | |
+-+ + + +-+-+-+-+-+-+ + +-+-+ +
|   |               |   |     E
+-+-+-+-+-+-+-+-+-+-+-+-+-+-+-+