+-+-+-+-+-+-+-+-+-+-+-+-+-+-+-+
S |       |   |             | |
+ +-+-+ + + + + +-+-+ +-+-+ + +
|       | | | |   |   |   | | |
+-+-+-+-+ +-+ + + +-+-+ + + + +
|       |   | | |     | | | | |
+ +-+-+ +-+ + + +-+-+ + + + + +
|   | |     | |     |   | | | |
+ + + +-+-+-+ + +-+-+-+-+-+ + +
| |   |       | |       |     |
+ +-+-+ +-+ +-+ + +-+-+ + + +-+
|       |   |   | |   | | |   |
+-+ +-+-+ +-+-+-+ + + + + +-+ +
|   |   |   |   |   | |   | | |
+ +-+ + +-+ + + + +-+-+-+-+ + +
| |   | |   | | |     |     | |
+ + +-+ +-+-+ + +-+-+ + +-+-+ +
| |   |       |   |   |       |
+ +-+ +-+-+-+-+-+ + + + +-+-+ +
|   | |     |     | | | |   | |
+-+ + + +-+-+ +-+-+-+ + + + +-+
| |   |             | |   |   |
+ +-+-+-+-+-+-+ +-+ + +-+-+-+ +
|             | |   |   |   | |
+-+-+-+-+-+-+ + + +-+-+ + + + +
|     |       | |     | | |   |
+ +-+-+ +-+-+ + +-+-+ + + +-+-+
| |     |     | |     | |     |
+ + +-+-+ + +-+ + +-+-+ +-+-+ +
|   |     |     |       |     E
+-+-+-+-+-+-+-+-+-+-+-+-+-+-+-+