+-+-+-+-+-+-+-+-+-+-+-+-+-+-+-+
S             |   |           |
+ +-+-+-+-+-+ +-+ + +-+-+-+-+ +
|     |     |       |       | |
+ +-+-+ +-+ +-+-+-+-+ +-+-+ + +
| |   |   | |       |   | |   |
+ + + +-+-+ + +-+-+ +-+ + +-+-+
| | | |   | | |   |   |       |
+ + + + + + + + + + +-+-+ +-+ +
| | |   | | |   | |     | |   |
+ + +-+-+ + +-+-+ + +-+ +-+ +-+
|       | |   |   |   |   |   |
+-+-+-+-+ +-+ +-+-+-+-+-+ +-+ +
|       | |       |   |     | |
+ +-+-+ + +-+-+ +-+ + + +-+ + +
| |   |   |   |   | | |   | | |
+ + + +-+-+ + +-+ +-+ +-+ + + +
|   |   |   | |   |   |   | | |
+-+-+-+ + +-+-+ +-+ +-+-+-+ + +
|   | |     |   |           | |
+ + + +-+-+ + +-+ + +-+-+-+-+ +
| |   |     |   | |     |     |
+ +-+-+ + +-+-+ +-+ +-+ +-+ + +
|   |   |     |   | | |   | | |
+-+ + +-+-+-+ +-+ + + +-+ + +-+
|     |     |     |   |   |   |
+ +-+-+-+ + +-+-+-+-+-+ +-+-+ +
|   |     |     |     | |     |
+-+ + +-+-+-+-+ + + + + + +-+-+
|     |           | |   |     E
+-+-+-+-+-+-+-+-+-+-+-+-+-+-+-+