+-+-+-+-+-+-+-+-+-+-+-+-+-+-+-+
S         |   |               |
+-+-+-+-+ + + + +-+-+-+-+-+-+ +
| |     |   |   |             |
+ + +-+ +-+ + +-+ + +-+-+-+-+-+
|   |   |   |   | |   |       |
+-+-+ +-+-+-+-+-+ +-+ + +-+-+ +
|   |             |   |   |   |
+ + +-+-+-+-+-+-+-+ +-+-+ + +-+
| | |                 |   |   |
+ +-+ +-+-+-+-+ +-+-+ + +-+-+ +
|     |         |   | |   |   |
+-+-+-+ +-+-+-+-+ + + +-+ + +-+
|     |   |       |     | |   |
+ +-+ +-+-+ +-+-+-+-+-+-+ +-+ +
|   |     | |   |   |   |   | |
+ +-+-+-+ + + +-+ + + + +-+ + +
| |     |   |     | | |   | | |
+ + +-+ +-+ +-+-+-+ + +-+ + + +
| | | | | |   |   |   |   | | |
+ + + + + + + + + +-+-+ +-+ + +
|   | | |   | | |         | | |
+-+-+ + +-+-+ + +-+-+-+ + + + +
| |   |   |   |       | | | | |
+ + +-+-+ + +-+-+-+ +-+ + + + +
| |       |       | |   |   | |
+ +-+-+-+-+-+ +-+ + + +-+-+-+ +
| |         |   | | | |       |
+ + +-+-+-+ +-+-+ +-+ + +-+-+-+
|         |           |       E
+-+-+-+-+-+-+-+-+-+-+-+-+-+-+-+