+-+-+-+-+-+-+-+-+-+-+-+-+-+-+-+
S           |   |   |   |     |
+-+ +-+-+-+ +-+ + + + + + +-+ +
| |   | |   |   | |   |   | | |
+ +-+ + + +-+ +-+ + +-+-+-+ + +
|     |   |       |     |     |
+-+-+-+ +-+ +-+-+-+-+-+ + +-+-+
|         |     |     | |     |
+ +-+-+ +-+ +-+ + + + + +-+-+ +
|     |   | | | | | | |     | |
+-+-+ +-+ + + + + +-+ +-+-+-+ +
| |   |   |   |   |     |   | |
+ + +-+ + +-+-+-+-+ +-+-+ + + +
|   |   | |   |     |     |   |
+-+-+ +-+-+ + + +-+-+ +-+-+-+-+
|     |     |     |   |   |   |
+ +-+-+ +-+ +-+-+ + +-+ + +-+ +
| |     |   |   | |     |     |
+ + +-+-+ +-+ + + +-+-+-+-+-+-+
|   |   |     | | |   |       |
+-+-+ + +-+-+-+ + + + + +-+ + +
|     |         |   | | | | | |
+ +-+-+-+-+-+-+-+ +-+ + + + + +
|             | |   |   |   | |
+-+-+-+-+ +-+ + + + +-+-+-+-+ +
|     |   |   |   | |     | | |
+ +-+ + +-+-+ + +-+ + +-+ + + +
|   |   |   | | |     | | |   |
+-+ +-+-+ + +-+ + +-+-+ + +-+-+
|   |     |     |     |       E
+-+-+-+-+-+-+-+-+-+-+-+-+-+-+-+