+-+-+-+-+-+-+-+-+-+-+-+-+-+-+-+
S       |   |     |   |   |   |
+ +-+-+ + + +-+-+ + + +-+ + +-+
|   | |   |       | | |       |
+ + + +-+-+-+-+-+-+-+ + +-+-+ +
| | |   |     |   |   | | |   |
+-+ +-+ + +-+ +-+ + +-+ + + +-+
|     | | |   |   |   |   |   |
+ +-+ + + + +-+ +-+-+ +-+-+-+ +
| |   |   |   | |         |   |
+-+ +-+-+ +-+ + + +-+ +-+ +-+ +
|     |   |   | | |   |   |   |
+ +-+-+ +-+ +-+ +-+ +-+ +-+ + +
| |     |   |     | | | |   | |
+ + +-+-+ +-+ +-+ + + + + +-+-+
|   |   |     | | |   |   |   |
+ +-+ + +-+-+ + + + + +-+-+-+ +
| |   | | |   |   | | |       |
+ + +-+ + + +-+-+-+ +-+ + +-+-+
| | |   | |     |       |     |
+ + +-+-+ +-+-+ + + +-+-+-+-+ +
| | |   | |     | |         | |
+ + + + + + +-+-+-+-+-+-+-+-+ +
| |   | | |       |           |
+ +-+-+ + + +-+-+ + +-+-+-+-+-+
|   |   |   |       |         |
+-+ + +-+-+ + +-+-+-+ +-+-+-+ +
|   | |     |       |   |   | |
+ + + + +-+-+-+-+-+ + + + +-+ +
| |   |           |   | |     E
+-+-+-+-+-+-+-+-+-+-+-+-+-+-+-+