+-+-+-+-+-+-+-+-+-+-+-+-+-+-+-+
S         |   |     |     |   |
+ + +-+ +-+ + + +-+ + +-+ + + +
| |   |   | | | | |     |   | |
+-+-+ +-+ +-+ + + +-+-+ +-+-+ +
|   | | |     |   | |   |     |
+ + + + +-+-+-+-+ + + +-+ +-+-+
| |   |   | |     | | |       |
+ +-+-+-+ + + + +-+ + + +-+-+-+
|   |   |   | |   |   |   |   |
+-+ + + +-+ + +-+ +-+-+-+-+ + +
|   | | |   |   |   |     | | |
+ +-+ + + + + + +-+ + +-+ +-+ +
|   | | | |   | |   | |     | |
+ +-+ + + +-+-+ + +-+ + +-+ + +
|     | |     | | |   | |   | |
+-+-+-+ +-+ + +-+ + + + + +-+ +
|     |   | |   |   | | | |   |
+-+-+ +-+ +-+-+ +-+-+-+ + +-+ +
|       |   |   |       |   | |
+ +-+-+-+-+ + +-+ +-+-+-+-+ + +
|     |     | | | |   |   |   |
+-+ + + +-+-+ + + + + + + +-+-+
|   |         | |   |   |     |
+-+-+-+-+-+ +-+ +-+-+-+ + +-+ +
|           |   |       |   | |
+ +-+-+-+-+-+ + +-+-+-+-+-+ + +
|     | |     | |       |   | |
+-+-+ + + +-+-+ + +-+-+ + +-+ +
|     |       |       |   |   E
+-+-+-+-+-+-+-+-+-+-+-+-+-+-+-+