+-+-+-+-+-+-+-+-+-+-+-+-+-+-+-+
S         |         |     |   |
+-+-+ +-+ +-+ +-+-+ + +-+ + + +
|   | | |   |   |   | |     | |
+ +-+ + +-+ + + + +-+-+ + +-+ +
|     |   | | | |     | |   | |
+ + +-+ +-+ +-+ +-+-+ + +-+ + +
| |   |   | |   | |     |   | |
+-+-+ +-+ + + +-+ + + +-+-+-+ +
|     |   |   | | | |     |   |
+ +-+-+ +-+-+-+ + + +-+-+ + +-+
| | |   |       |     |   |   |
+ + + +-+ +-+ +-+-+-+-+ +-+-+ +
|     |   |     | |     |     |
+ +-+-+ +-+-+-+ + + +-+-+ +-+-+
| |     |     | |     |   |   |
+ +-+-+ +-+-+ + +-+ +-+ +-+ +-+
| |     |   | |   |   |   |   |
+ + +-+-+ + + +-+ +-+ +-+ +-+ +
| |       | | |     |   |   | |
+ +-+-+-+ + + +-+-+ +-+ +-+ + +
|     |   |   |   |     | | | |
+-+-+ + +-+-+-+ + + +-+-+ + + +
| |   | |     | | |       |   |
+ + +-+-+ +-+ +-+ + +-+-+-+-+ +
|         |   |   | |     |   |
+-+-+-+-+-+ +-+ +-+ + + + + +-+
|   |   |       |   | | | | | |
+ + + + +-+-+ +-+ +-+ + +-+ + +
| |   |       |   |   |       E
+-+-+-+-+-+-+-+-+-+-+-+-+-+-+-+