+-+-+-+-+-+-+-+-+-+-+-+-+-+-+-+
S |     |             |   |   |
+ + +-+ + +-+-+-+-+-+ + + + + +
| | |   | |     | |   | |   | |
+ + + +-+ + +-+ + + +-+ + +-+ +
|   |   | | | |   |     |   | |
+-+-+-+ + + + +-+-+ +-+-+-+ +-+
|       |   |   |     |       |
+ +-+-+-+-+-+-+ + +-+-+ +-+-+ +
| |     |   | |   |   |   |   |
+ + +-+ +-+ + +-+-+-+ +-+ + +-+
| |   |     |       |     |   |
+ +-+ +-+-+ + +-+-+ +-+-+ +-+ +
| |   |   | | |   | |     |   |
+ + +-+ + + + + + +-+ +-+-+ +-+
|     | | |   | |     |   | | |
+-+ + + + +-+-+ +-+-+-+ + + + +
|   |   |   |   |       |   | |
+ +-+-+-+-+-+ + + +-+-+-+-+-+ +
| |     |     | |           | |
+ +-+-+ + +-+-+-+-+-+-+-+ + + +
|   |   |   |     |     | |   |
+ + + + + + + +-+ +-+-+ + +-+-+
| |   | | |   |     |   | |   |
+-+-+-+ + +-+-+ + + + +-+-+ + +
|       |   | | | | |       | |
+ +-+-+-+-+ + + + + + +-+ +-+ +
|     |     |   | |   | | |   |
+-+ + + +-+-+-+-+ +-+-+ + + +-+
|   |   |             |   |   E
+-+-+-+-+-+-+-+-+-+-+-+-+-+-+-+