+-+-+-+-+-+-+-+-+-+-+-+-+-+-+-+
S   |         |     |   |     |
+ +-+ +-+-+-+ +-+-+ + + + +-+ +
| |   |   | |   |   | |   |   |
+ + +-+ + + +-+ + +-+-+-+ +-+-+
| |     | |       |     |     |
+ +-+-+-+ +-+-+ +-+ +-+ +-+-+ +
| |       |   | |   |       | |
+ +-+-+-+ + + + +-+-+-+ +-+ + +
|       | | |   |   |   | |   |
+ +-+-+ +-+ +-+-+ + + +-+ +-+ +
|     | |   |   | |   | |   | |
+-+-+-+ + +-+ +-+ +-+-+ +-+ + +
|     | | |     |   |     |   |
+ +-+ + + + +-+ +-+ + + + +-+-+
|   | | |   |   |   | | | |   |
+-+ + + +-+-+ + + +-+-+ + +-+ +
|   |   |   | | |   |   | |   |
+-+-+ +-+ + + +-+ +-+ +-+ + + +
|   | |   | |   | |     | | | |
+ + + + +-+ +-+ + + + + +-+ +-+
| |   | | | |   | | | |   |   |
+ +-+-+ + + + +-+ + + +-+ +-+ +
| |     | | | |   | |   | |   |
+ + +-+-+ + + + +-+-+-+ + + + +
|   |   |       |       |   | |
+ +-+ + +-+ + +-+ +-+-+ +-+-+ +
| |   | |   |     |   |   |   |
+ + +-+-+ +-+-+-+-+ + +-+-+ +-+
| |       |         |         E
+-+-+-+-+-+-+-+-+-+-+-+-+-+-+-+