+-+-+-+-+-+-+-+-+-+-+-+-+-+-+-+
S |       | |       |   |   | |
+ + +-+-+ + + +-+-+ + +-+ + + +
| | | |   |   |         | |   |
+ + + + +-+-+-+-+-+ +-+ + +-+ +
|   | | |       |     | | |   |
+-+-+ + + +-+-+ +-+ + + + + + +
| |   |   |     |   | |   | | |
+ + + +-+-+ +-+-+ +-+-+-+-+ + +
|   | |     |     |       | | |
+-+-+ + +-+-+ +-+-+ +-+-+ + + +
|   | |     | |     |   |   | |
+ + + +-+-+ + + +-+-+ + +-+-+ +
| | | |   |   |   |   | |   | |
+ +-+ + + +-+-+-+ + + +-+ + +-+
|     | |         | |     |   |
+ +-+-+-+-+-+-+ +-+ +-+-+-+-+ +
|           |   |     |     | |
+-+-+-+-+-+ + + + +-+-+ +-+ + +
|         | | |   |     | |   |
+ +-+-+-+-+ +-+-+-+ +-+-+ +-+-+
|         |           |     | |
+ +-+-+-+ +-+-+-+-+ + + +-+ + +
|       |   |   |   | |   |   |
+-+-+-+ +-+ + + + +-+ +-+ +-+-+
|       | |   | |   |         |
+ +-+-+-+ +-+-+ +-+ +-+-+ +-+ +
|   |   | |   |     | |   |   |
+-+ + + + + +-+-+ + + + +-+ + +
|     |   |       | |   |   | E
+-+-+-+-+-+-+-+-+-+-+-+-+-+-+-+