+-+-+-+-+-+-+-+-+-+-+-+-+-+-+-+
S   |       |           | |   |
+ + + + +-+ + +-+-+ +-+ + + + +
| | | |   |   |   | |   |   | |
+ + +-+ + +-+-+-+ + +-+ +-+ + +
| | |   |       | | |       | |
+ +-+ +-+-+-+-+ + + + +-+-+-+ +
| |   |         |   | |   |   |
+ + +-+ +-+ +-+ +-+ + + + +-+ +
|   | | |   |   |   | | | |   |
+-+-+ + + +-+-+-+ +-+-+ +-+ +-+
|   |   |   |     |         | |
+ + +-+-+-+-+ +-+-+ +-+ +-+-+ +
| |     |     | |   | |   |   |
+-+-+-+ + +-+-+ + +-+ +-+ + +-+
|     | | |     |   |     |   |
+ + + + + + +-+-+-+ +-+-+-+-+ +
| | | | | |         |       | |
+ + +-+ + +-+ +-+-+-+-+-+-+ + +
| |   |   | | |   |       | | |
+ +-+ + +-+ + + + + +-+ + + + +
|   |     | | | |   |   | | | |
+-+ +-+-+ + + + +-+-+ +-+ + + +
| | |   | |   |   |   |   | | |
+ + + + +-+-+-+-+ + +-+-+-+ + +
|   | |   |   |   |       |   |
+-+ + +-+ + + + +-+ +-+-+ +-+ +
|   |   | | | |   | |   |   | |
+ +-+-+-+ + + +-+ + + + +-+ + +
|           |     |   |   |   E
+-+-+-+-+-+-+-+-+-+-+-+-+-+-+-+