+-+-+-+-+-+-+-+-+-+-+-+-+-+-+-+
S             |         |     |
+ +-+-+-+-+-+ + +-+-+-+ + + + +
|     |       |     |   | | | |
+ + +-+ +-+-+-+-+-+ + +-+ + + +
| |   |   |   |     |   | | | |
+-+-+ +-+ + + +-+ +-+-+ +-+ + +
|   |   |   | |   |     |   | |
+ + +-+ + +-+-+ +-+ +-+-+ +-+-+
| | |   |       |   |   |     |
+ + + +-+-+-+-+-+ +-+ + +-+-+ +
| | |     | |   | |   |   |   |
+ +-+-+-+ + + + + + +-+ + +-+ +
| |   |   |   |   |   | |     |
+ + + + +-+-+-+-+ +-+-+ +-+-+-+
|   |   |       | |   | |   | |
+ +-+-+ + +-+-+ + + + + + + + +
| |   | |     |     |   | |   |
+ +-+ + +-+ +-+-+-+-+-+-+ +-+-+
|     | | |     |     | |     |
+-+-+-+ + +-+-+ +-+-+ + +-+ + +
| |     | |   |       |     | |
+ + +-+-+ + + +-+-+ +-+-+-+ + +
| |     |   |     |   |   | | |
+ +-+-+ + +-+-+-+-+-+ + +-+ + +
|   |   | |             |   | |
+-+ + + + + +-+-+-+-+-+-+ +-+ +
|     | | | |   |   |   | |   |
+ +-+-+-+ + + + + + + + + + +-+
|         |   |   |   |   |   E
+-+-+-+-+-+-+-+-+-+-+-+-+-+-+-+