+-+-+-+-+-+-+-+-+-+-+-+-+-+-+-+
S     |   |             |   | |
+ +-+ + + + +-+-+-+ +-+ + + + +
|   | | | |   |   | |   | | | |
+-+-+ + + +-+ + + + +-+-+ + + +
|     | | |   | |   |   | |   |
+ +-+-+-+ + +-+-+ +-+ + + +-+-+
| |     | | |     |   |   |   |
+ +-+-+ + + + +-+-+ +-+-+-+ + +
| |       | | |   |     |   | |
+ + +-+-+-+ + + + +-+-+ + +-+ +
|   |       |   |     | | |   |
+ +-+-+ +-+ + +-+-+-+ + + + +-+
|         | | |       | | |   |
+-+-+-+-+ + +-+ + +-+-+ + +-+ +
|     |   |   | |   |   | | | |
+-+-+ + +-+ + +-+-+ + +-+ + + +
|       | | |     |   |   |   |
+ +-+-+-+ + +-+-+ +-+-+ +-+-+-+
|   |   |   |   |   |   |     |
+-+ +-+ +-+-+ + +-+ +-+ + +-+ +
|       |   | | |       | |   |
+-+-+-+-+ + +-+ + + +-+-+ + +-+
|       | |     | |     | | | |
+ +-+-+ + +-+-+-+ + +-+ + + + +
|     | | |   |   |   |   | | |
+-+-+ + + + + + +-+-+ +-+ + + +
| |   | |   |   |     |   |   |
+ + +-+ +-+-+-+-+ +-+-+ +-+ + +
|   |             |     |   | E
+-+-+-+-+-+-+-+-+-+-+-+-+-+-+-+