+-+-+-+-+-+-+-+-+-+-+-+-+-+-+-+
S       |       |             |
+ +-+-+ + +-+-+ +-+-+ +-+-+-+ +
| |     |     |   |   |   |   |
+ + +-+-+-+-+-+-+ +-+ + + + +-+
| |   | |       |   | | | |   |
+ +-+ + + +-+ +-+-+ +-+ + +-+ +
| |   |     |     | |   | |   |
+-+ +-+-+ + +-+-+ + + +-+ +-+ +
|   |     |   |   |   |   |   |
+ +-+-+-+-+-+ + +-+ +-+ +-+ +-+
| |   |   |   | |   |   | |   |
+ + + +-+ + +-+ + +-+ +-+ +-+ +
| | |       | |     |     | | |
+ + +-+-+-+-+ +-+-+-+-+ +-+ + +
| | |       |     |   |     | |
+ + + +-+-+ +-+-+ + + + +-+-+ +
|   | |     |     | | |   |   |
+-+-+ + +-+-+-+ +-+ +-+-+ + +-+
|     |     |   |         | | |
+ +-+-+-+-+ + +-+ + +-+-+-+ + +
|         | |     | |     |   |
+-+-+-+-+ + +-+-+-+ + +-+ + +-+
|   |   | |       | | |   |   |
+ + + + + +-+-+-+ + + + +-+-+ +
| |   | |     |       |     | |
+ +-+-+-+-+-+ +-+-+ +-+-+-+ + +
|   | |     | |     |       | |
+ + + + + +-+ + +-+-+ +-+-+-+ +
| |     |     |     |         E
+-+-+-+-+-+-+-+-+-+-+-+-+-+-+-+