+-+-+-+-+-+-+-+-+-+-+-+-+-+-+-+
S   |       | |     |   |   | |
+-+ + +-+-+ + + +-+ + + + + + +
|   | |     | |   |   |   | | |
+ +-+ + +-+-+ +-+ +-+-+-+-+ + +
|   | | |       |         | | |
+-+ + + + +-+ +-+-+-+-+-+ + + +
|   | | |   | |           | | |
+ +-+ + +-+-+ + +-+-+-+-+ + + +
| |   |     | |       |   |   |
+ + +-+-+-+ + +-+-+-+ + + +-+-+
| |     | | |   | |   | |     |
+ +-+-+ + + +-+ + + +-+-+-+-+ +
| |   |   |   | |   |       | |
+ + +-+ +-+-+ + +-+-+-+ +-+ + +
| |     |   | |         |     |
+ +-+-+-+-+ + +-+-+-+-+ + + +-+
| |   |       |       | | |   |
+ + + +-+-+-+ + +-+-+ + + +-+ +
|   | |       | |   | | |   | |
+ +-+ + +-+-+-+ + + + +-+-+ +-+
|   | |   |     | | |     |   |
+-+ +-+-+ + +-+-+ + +-+-+ +-+ +
| |   |     |     |     |     |
+ +-+ + +-+-+ +-+-+-+-+ + +-+-+
| | | | |     |               |
+ + + + + +-+-+-+-+-+-+-+ +-+ +
|   |   |   |           |   | |
+-+ +-+-+ + + +-+-+-+-+ +-+-+ +
|         | |         |       E
+-+-+-+-+-+-+-+-+-+-+-+-+-+-+-+