+-+-+-+-+-+-+-+-+-+-+-+-+-+-+-+
S     |   |   |       |       |
+ +-+ +-+ + + +-+-+ + + +-+-+-+
| | |     | |       | |       |
+ + +-+-+-+ +-+-+-+-+ +-+-+-+ +
|               |   | |       |
+ +-+-+-+-+ +-+ + +-+ + +-+-+-+
| |   |     |   |       |     |
+ + + +-+ +-+-+-+-+-+ +-+ +-+ +
| | |     |     |   |   | |   |
+ + +-+-+-+ +-+ + + +-+ + + +-+
| |   |   | |   | | | |   |   |
+-+-+ + + + + +-+ + + +-+-+-+ +
|   |   |   | |   |   |       |
+ +-+-+-+-+-+ + + +-+-+ +-+ +-+
|             | | |   | |   | |
+-+-+ +-+-+-+-+ + + + +-+ +-+ +
|   |   |       |   |     |   |
+ + +-+-+ +-+-+-+-+-+ +-+-+ + +
| | |     |   |         |   | |
+ +-+ + +-+-+ + +-+-+ +-+ +-+-+
|     |   |   |   | |   |     |
+-+-+-+-+ + +-+-+ + +-+ +-+ + +
|           |   |     |   | | |
+-+-+-+-+-+-+ +-+-+-+ +-+ +-+ +
|   |   |     |     | |     | |
+ + +-+ + +-+-+ +-+ +-+ + + + +
| |     |     |   | |   | | | |
+ +-+-+ +-+-+ +-+ + + +-+ + + +
|     |           |   |   |   E
+-+-+-+-+-+-+-+-+-+-+-+-+-+-+-+