+-+-+-+-+-+-+-+-+-+-+-+-+-+-+-+
S   |     |   |       |     | |
+-+ + +-+ +-+ +-+-+-+ + + + + +
|   | |     |       |   | | | |
+ +-+ +-+-+ +-+-+-+ +-+-+-+ + +
| |   |     |   | |   |   | | |
+ + +-+ +-+-+ + + +-+ + + + + +
|   |   |   | | |       | |   |
+-+-+ +-+ + + + +-+-+ +-+ + +-+
|   |     | | | |   | | | |   |
+ + +-+-+-+ + + + + + + + + + +
| | |     |   |   |   |   | | |
+ + + +-+ +-+-+-+-+ +-+-+ + +-+
| |     |   |       |     |   |
+ +-+-+-+-+ + +-+-+-+ +-+-+ + +
|       |     | |   |       | |
+-+-+-+ +-+-+ + + +-+-+-+-+-+ +
| |   |     | | |   |       | |
+ + + +-+-+ +-+ +-+ + +-+ + + +
| | | |     |     |     | | | |
+ + + + +-+-+ + + +-+-+ +-+ + +
|   | |       | | | |   |   | |
+ +-+ +-+-+ +-+-+ + + +-+ +-+ +
|   |   |   |     | | |   | | |
+-+ +-+-+ +-+ +-+-+ + +-+-+ + +
|           |       |         |
+-+-+-+-+ + +-+-+ +-+-+-+ +-+-+
|   |     | |     | |     |   |
+ +-+ +-+-+ + +-+-+ + +-+-+-+ +
|     |     |       |         E
+-+-+-+-+-+-+-+-+-+-+-+-+-+-+-+