+-+-+-+-+-+-+-+-+-+-+-+-+-+-+-+
S   |         |   |     |   | |
+ + + +-+-+-+-+ + + +-+ +-+ + +
| |   |       | |     | |   | |
+ +-+-+ +-+-+ +-+-+ + + + +-+ +
| |   |   | |     | | |       |
+ + + + + + +-+-+ + +-+-+-+-+-+
|   |   |       |   |   |     |
+-+ +-+-+-+ +-+ +-+-+ + + +-+ +
|   |     |   |   |   | | |   |
+ +-+ +-+ + + +-+ +-+ + + + +-+
| |   | | | |   | |   |   | | |
+ + +-+ + +-+-+-+ + +-+-+-+ + +
| |     | |   |   | |     | | |
+ +-+-+ + + + + +-+ + +-+ + + +
|     | |   | |     | |       |
+-+-+ + + + +-+-+-+-+ + +-+-+-+
| |   | | | |     |   | |     |
+ + +-+ + + + +-+-+ +-+ + + +-+
|   |   | | |       |   | |   |
+-+ + + + +-+-+-+-+-+ +-+ +-+ +
| |   | |   |   |   |     |   |
+ +-+-+-+-+ + + + + +-+-+-+ +-+
| | |       | | | |     |   | |
+ + + +-+ +-+ +-+ +-+-+ + +-+ +
| | | | |   |   |   |   | |   |
+ + + + +-+ + + +-+ +-+ + + +-+
| | | |     | |   |   | |     |
+ + + +-+-+-+ +-+ +-+ +-+-+-+ +
|           |   |             E
+-+-+-+-+-+-+-+-+-+-+-+-+-+-+-+