+-+-+-+-+-+-+-+-+-+-+-+-+-+-+-+
S   |     |   |     |         |
+ + + +-+ +-+ + +-+ + +-+-+ +-+
| | | |   |     |   |     |   |
+-+ + + + + +-+-+ +-+-+-+-+ + +
|   | | | |     |       |   | |
+ +-+ + +-+-+-+ +-+ +-+ + +-+ +
|   | |         |   |     |   |
+-+ + +-+-+-+-+-+ +-+-+-+-+-+-+
|   |   |       |       |     |
+ +-+ + + +-+ +-+-+-+-+ + +-+ +
|     |   |         |     | | |
+-+-+-+-+-+ +-+-+-+ +-+-+-+ + +
|   |       |     |     |     |
+ + +-+-+-+ + +-+ + +-+ + + +-+
| |       |   |   | |   | |   |
+ +-+-+-+ +-+-+ +-+-+ +-+-+-+ +
| |   | |     | |     |       |
+ + + + + +-+-+ + +-+-+ +-+ +-+
|   | | |       | |     |     |
+ +-+ + +-+ +-+-+ + +-+-+ +-+ +
| | | | |   |     |     |   | |
+ + + + +-+-+ +-+-+-+-+ +-+ + +
|   | |       | |       | | | |
+-+-+ +-+-+-+-+ + + +-+-+ + +-+
|         |   |   | |     |   |
+ +-+-+-+ +-+ +-+-+ + + +-+-+ +
|     | |     |   |   | |   | |
+-+-+ + + +-+ + +-+-+-+ + +-+ +
|     |   |   |         |     E
+-+-+-+-+-+-+-+-+-+-+-+-+-+-+-+