+-+-+-+-+-+-+-+-+-+-+-+-+-+-+-+
S           |     |           |
+ +-+-+-+-+ + +-+ + +-+-+-+ +-+
| | |   |     | |   |     |   |
+ + + + + +-+-+ +-+-+ +-+-+-+ +
|   | | |   |   |             |
+-+ +-+ +-+ + +-+ +-+ +-+-+ + +
|   |   |   | | | | | |   | | |
+ +-+ + + +-+ + + + + + + + +-+
| |   | | |   |   |     | |   |
+ + +-+ + + +-+ +-+-+ +-+ +-+ +
|     | | |   |   |   |   |   |
+-+-+ +-+ + + +-+-+ +-+ +-+-+-+
|   | |   | | |   | |   |     |
+ + + + +-+ +-+ + + + +-+ +-+ +
| | | | | |     |   |   |   | |
+ + + + + +-+-+-+-+-+-+ +-+-+ +
| | | | | |   |       |       |
+ + +-+ + + + +-+ +-+ +-+-+-+-+
| |       | |     | | |       |
+ +-+-+-+-+ +-+-+-+ + + +-+-+ +
|     |   |     |     |   |   |
+-+-+ +-+ +-+ + +-+-+-+-+ +-+ +
| |   |   |   |       |   |   |
+ + +-+ +-+ +-+-+ +-+ + + + +-+
| |         |     |   | | | | |
+ +-+-+ +-+-+ +-+-+ +-+ + + + +
|       |     |   |   | | | | |
+-+-+-+-+ + +-+-+ +-+ + + + + +
|         |       |     | |   E
+-+-+-+-+-+-+-+-+-+-+-+-+-+-+-+