+-+-+-+-+-+-+-+-+-+-+-+-+-+-+-+
S     |       |           |   |
+ +-+ + +-+-+ + +-+-+-+ + + +-+
|   |   |     |       | | |   |
+-+ +-+-+-+ +-+-+-+-+-+ + +-+ +
|   |       |   |   |   |     |
+ +-+ +-+-+-+ + + + + +-+-+-+-+
|   |       | | | |   |   |   |
+ + +-+ +-+ +-+ +-+ + + + + + +
| |   |   |   |   | | | |   | |
+ +-+ +-+-+-+ +-+ + +-+ +-+ +-+
|   | |     |   |     |   |   |
+-+ +-+ + + +-+ +-+ + +-+-+ + +
|   |   | | |   |   |   |   | |
+ +-+ + + +-+ +-+ +-+-+ + +-+ +
| |   | | |   |   |   | | | | |
+ + +-+ + + +-+ +-+-+ + + + + +
| | |   | |           | | |   |
+ + + +-+ +-+-+ +-+-+-+ + +-+-+
| | | |   |     | |     | |   |
+ + +-+ +-+ +-+-+ + +-+ + + +-+
| | |   |   |       |   | |   |
+ + + +-+-+ + + +-+-+-+-+ +-+ +
| | | | |   | | |       | |   |
+ + + + + +-+ +-+ +-+-+ + + +-+
| | | |   |   |   |     |     |
+ + + +-+-+ +-+ +-+ +-+-+-+ + +
| | | |       |   | |       | |
+ +-+ + +-+-+-+-+ + + +-+-+-+ +
|     |           |   |       E
+-+-+-+-+-+-+-+-+-+-+-+-+-+-+-+