+-+-+-+-+-+-+-+-+-+-+-+-+-+-+-+
S | |   |   |     |   |       |
+ + + + + + + + +-+ + + + +-+ +
| |   | | |   |     | | | |   |
+ +-+-+ + +-+-+-+-+-+ +-+ + +-+
| |     | |           |   | | |
+ + +-+-+ + +-+-+-+-+-+ +-+ + +
| |       |   |     |   | |   |
+ +-+ +-+-+-+ + +-+ + +-+ +-+-+
| |   |   |   |   |   |   |   |
+ + +-+ + + +-+-+ +-+-+ + + + +
|   | | |   |     |     | | | |
+ +-+ + +-+-+ +-+-+ +-+-+ + + +
| |   | |     |     |   | | | |
+ + +-+ + +-+ + +-+-+ + + + + +
| |       |   | |     |     | |
+ +-+-+ +-+-+-+ + +-+-+-+-+-+ +
| |     |       | |     |   | |
+-+ +-+-+ +-+-+-+ + +-+ +-+ + +
|   |     |   | |     |     | |
+ +-+ +-+ +-+ + +-+-+ + +-+-+ +
|     |   |   | |   | | |   | |
+ +-+-+-+-+ +-+ + + +-+ + + + +
| |       |     | |     | | | |
+-+ +-+-+ +-+ +-+ +-+-+-+-+ + +
|   |       | |   |         | |
+ +-+ +-+ + + + +-+ +-+-+-+-+ +
| |   | | | |       |         |
+ + +-+ + +-+-+ +-+-+ +-+ +-+-+
| |     |       |     |       E
+-+-+-+-+-+-+-+-+-+-+-+-+-+-+-+