+-+-+-+-+-+-+-+-+-+-+-+-+-+-+-+
S   | |       |   |     |     |
+-+ + + +-+-+ + + + +-+ + +-+ +
|   |   |     | | | |   |   | |
+ +-+ +-+ +-+-+ + + + +-+-+ + +
|   | | |     | | | | |     | |
+-+ + + +-+-+ +-+ +-+ +-+-+ + +
|     |   | |     |   |     | |
+ +-+-+-+ + +-+-+ + +-+ +-+ +-+
|   | |   |       |   | |     |
+-+ + + +-+-+-+-+-+-+ + +-+ + +
|   |       | |         |   | |
+ +-+-+-+ + + + +-+-+ + + +-+-+
|     |   |   | |   | | | |   |
+-+-+ + +-+-+-+ + + + +-+ + + +
|   | | |     |   | | |   | | |
+ + + + + +-+ +-+-+ + + + + + +
| |   | |   |   | | | | | | | |
+ +-+-+ + + +-+ + + +-+ + + + +
|   | |   | |   |   |   | | | |
+-+ + + +-+-+ +-+-+-+ +-+ + +-+
|   | | |   |       | | | |   |
+-+ + + + + +-+ +-+ + + + +-+ +
|   | | | | |   |   |   |   | |
+ + + +-+ + +-+-+ +-+-+ + +-+ +
| |       |     | |     | |   |
+ +-+ +-+-+-+-+ + + +-+-+ + +-+
| | |   |     |   | |     |   |
+ + +-+ +-+ + +-+-+ + +-+-+-+ +
|     |     |       |         E
+-+-+-+-+-+-+-+-+-+-+-+-+-+-+-+