+-+-+-+-+-+-+-+-+-+-+-+-+-+-+-+
S   |               |   |     |
+ +-+ +-+-+ + +-+-+ + + + +-+ +
|   | |     |     | | |   |   |
+-+ +-+ +-+-+-+-+-+ + + +-+ +-+
| |             |   | |   | | |
+ +-+-+-+-+-+-+ + +-+-+-+ + + +
|   |           |         | | |
+-+ + +-+-+-+-+-+-+-+-+-+-+ + +
|   |       |               | |
+ +-+-+-+-+ + +-+ +-+-+-+-+-+ +
|     |     | | | |   |       |
+ +-+ + +-+-+ + + + + +-+-+-+ +
| | | | |     |   | | |   |   |
+ + + +-+ +-+-+-+-+ + + + +-+ +
|   |   |       |   |   | |   |
+-+ +-+ +-+-+ + +-+-+-+-+ + +-+
|   | |       | |         |   |
+ +-+ +-+-+-+-+ + +-+-+-+-+-+ +
| |   | |   |   | |     |     |
+ + +-+ + + + +-+ + + +-+ +-+-+
| |     | | |       |   |   | |
+ +-+ +-+ +-+-+-+-+ +-+ +-+ + +
|   |   |   |     | |   |     |
+-+ +-+ +-+ + +-+ +-+ + + +-+-+
| |     | |   |       | |   | |
+ +-+-+-+ +-+-+ + +-+-+ +-+ + +
|   |   |     | |   |   |   | |
+ + + +-+-+ + + +-+ + +-+ + + +
| |         |   |   |     |   E
+-+-+-+-+-+-+-+-+-+-+-+-+-+-+-+