+-+-+-+-+-+-+-+-+-+-+-+-+-+-+-+
S       |   |             |   |
+ +-+-+ + + + +-+-+-+-+-+ + + +
|     |   | |   |   |     | | |
+-+-+ +-+-+ +-+ + +-+ +-+-+ + +
|     |   | |   |     |   | | |
+ +-+-+ + + + +-+-+-+-+ + + + +
| |   | | | |     |     | | | |
+ + + +-+ + +-+-+ + +-+-+ + + +
| | |     | | |   | |     | | |
+ + +-+-+-+ + + +-+ +-+-+ + + +
| | | |     | | |   |     | | |
+ + + + +-+-+ + + +-+ +-+-+ + +
| | | | |   | | |   |   |   | |
+ + + + + + + + +-+ +-+ + +-+ +
| |   |   |         |   | |   |
+ +-+ + +-+-+ + +-+-+-+ + + +-+
| | | | |   | |     |   | |   |
+ + + + +-+ + +-+-+-+ +-+ +-+ +
|   | |     | |   |   | | | | |
+-+ + + +-+-+-+ + + +-+ + + + +
| | | | |       | |       |   |
+ + + + + +-+-+-+ +-+-+-+-+ +-+
| |   |     |   |   |     |   |
+ +-+-+-+-+ + + +-+ + +-+ +-+ +
|     |   | | |   | | | |     |
+-+-+ + + + + +-+ + + + +-+-+-+
|   |   |   |   |   | |       |
+ +-+-+-+-+-+ + +-+-+ + +-+-+ +
|             |     |   |     E
+-+-+-+-+-+-+-+-+-+-+-+-+-+-+-+