+-+-+-+-+-+-+-+-+-+-+-+-+-+-+-+
S       |   |                 |
+-+-+-+ +-+ + +-+-+-+-+-+-+-+ +
|           |       |   |   | |
+ +-+-+-+-+-+-+-+-+-+ + + + + +
|         |         | |   | | |
+-+-+-+-+ + +-+-+-+ + +-+-+ + +
|   |     | |   |     |   |   |
+ +-+ +-+-+-+ + + + +-+ + +-+ +
|   |         | | | |   |     |
+-+ +-+-+-+ +-+ + + + +-+-+-+ +
| |   |   | | | | | |   |   | |
+ +-+ +-+ + + + +-+ +-+ + + +-+
|     |   |   |   | |   | |   |
+ + +-+ +-+-+-+-+ + + +-+ +-+ +
| |   | |     |   | |     |   |
+ +-+-+ + +-+ + +-+ +-+-+-+ +-+
|   |   |   |   |   |     |   |
+-+ + + +-+ +-+ + +-+ +-+ +-+ +
|   | |   | |   |   |   | |   |
+ + +-+-+ + + +-+-+ +-+ +-+ +-+
| | |   |   |     |   |   |   |
+-+ + + +-+-+-+ + +-+ +-+ + + +
|   | |     |   | | | | | | | |
+ +-+ +-+-+ + +-+ + + + + +-+ +
|       |     |     |   |     |
+-+ +-+ +-+-+-+ + +-+-+ +-+ +-+
| |   | |     | | |   | | |   |
+ +-+ + + +-+-+ + +-+ + + +-+ +
|     | |       |       |     E
+-+-+-+-+-+-+-+-+-+-+-+-+-+-+-+