+-+-+-+-+-+-+-+-+-+-+-+-+-+-+-+
S     |     |       |   |   | |
+-+-+ +-+-+ + +-+-+ + + +-+ + +
|   | |     |     |   |   | | |
+ + + + +-+-+-+-+ + +-+-+ + + +
| | | |     |   | | |   |     |
+ + + +-+-+ + + + + + + +-+-+-+
| |   |   | | | | | | |     | |
+ +-+-+ + + + + + + +-+-+ + + +
| |   | |     | | | |   | |   |
+ + + + +-+ +-+ +-+ + + + +-+ +
| | | |   | | |   | | |     | |
+ + + +-+-+ + +-+ + +-+ +-+ +-+
| | | |     | | |     |   |   |
+ + +-+ +-+-+ + +-+ + +-+ +-+ +
|     |   |   |     | |     | |
+-+ + +-+ + +-+ + +-+ + +-+ + +
|   | |   | |   |   |   |   | |
+ +-+ +-+-+ + +-+-+ +-+-+ +-+ +
|   |     | |     |   |     | |
+-+ +-+-+ + +-+-+-+-+ + +-+-+ +
|   |     |       |   | |   | |
+ +-+ +-+-+ +-+-+ +-+-+ + + + +
|   |   |   | |   |     | | | |
+-+ + + + +-+ + +-+ +-+-+ + + +
| | | | | | | |   |   |   | | |
+ + +-+ + + + +-+ +-+ + +-+ +-+
| |   | |   | |   |   | |     |
+ +-+ + + + + +-+ +-+ +-+ +-+ +
|     |   | |             |   E
+-+-+-+-+-+-+-+-+-+-+-+-+-+-+-+