+-+-+-+-+-+-+-+-+-+-+-+-+-+-+-+
S       |       |     |       |
+-+-+ +-+ +-+-+ + +-+ + + + +-+
| |   |   |   | | | |   | |   |
+ + +-+ +-+ + + + + +-+-+ + + +
|   | |     | |   |   |   | | |
+ +-+ +-+-+-+ +-+-+-+ + +-+-+ +
|     |     | | |     |     | |
+-+ +-+-+ + + + + +-+ +-+-+ + +
|     |   |   |     |   |   | |
+ +-+ + +-+-+-+-+-+-+-+ + + + +
|   | |     |             | | |
+-+ + +-+-+ +-+-+ +-+-+-+-+-+ +
| | |   | |     | | |     |   |
+ + +-+ + +-+-+ + + + +-+-+ + +
|   |   | | |   | | |       | |
+ +-+ +-+ + + +-+ + +-+-+-+-+ +
| | |     |   |   |       |   |
+ + +-+-+-+-+ + +-+-+-+-+ + +-+
| | |   |     | |     |   |   |
+ + + + + +-+-+ + +-+-+ +-+-+ +
| | | |   |     | | |   |   | |
+ + + +-+-+ + +-+ + + + + + + +
|   |   | | |     |   | | | | |
+ +-+-+ + + +-+-+-+ +-+ +-+ + +
|       | |           |   | | |
+-+-+-+-+ +-+ +-+-+-+-+-+ + + +
|     |     |   |         | | |
+ +-+ +-+-+ +-+ + +-+-+-+-+ + +
|   |           |           | E
+-+-+-+-+-+-+-+-+-+-+-+-+-+-+-+