+-+-+-+-+-+-+-+-+-+-+-+-+-+-+-+
S |   |   |   |     |   |   | |
+ + + +-+ + +-+ +-+ + +-+ + + +
|   |       |   |       | | | |
+ +-+-+-+ +-+ +-+ +-+-+ + + + +
| | |           |     |   | | |
+ + + +-+-+-+-+-+-+ +-+-+ + + +
| |         |   |     |   |   |
+ + +-+-+-+ +-+ + + + + +-+-+-+
| |   |   |   | | | | |   |   |
+-+-+ +-+ +-+ + + +-+ +-+ + + +
|   |   |     |   |   |   | | |
+ +-+-+ +-+-+-+-+-+ +-+-+-+ + +
|     | |     |     |       | |
+-+-+ + + +-+ + +-+-+ +-+ + + +
|   |   | |         | |   | | |
+ + +-+-+ + + +-+-+-+ +-+-+ + +
| |       | |   |   | |     | |
+ +-+-+-+-+ +-+ + + +-+ +-+-+-+
|   |     |   | | |     |     |
+-+ + + +-+-+ + + +-+-+-+ +-+ +
|   | | |   | | |       |   | |
+ +-+-+ + +-+ + +-+-+-+ +-+ +-+
| |   | |     |       |       |
+ + + + +-+-+-+-+ +-+-+-+-+-+ +
|   |   |       |     |       |
+-+ +-+-+ +-+ + +-+-+ + +-+-+-+
|   |     | | |   | |   |   | |
+ +-+-+ +-+ + +-+ + + + +-+ + +
|       |     |   |   |       E
+-+-+-+-+-+-+-+-+-+-+-+-+-+-+-+