+-+-+-+-+-+-+-+-+-+-+-+-+-+-+-+
S     | |       |   |       | |
+ +-+ + + +-+-+ +-+ + +-+ + + +
| | | |   |   |   |   |   | | |
+ + + + +-+ + + + + + +-+-+ + +
| |   | |   |   | | | |     | |
+ + +-+-+ +-+-+-+ + + + +-+-+ +
| |       |   |   | | |       |
+ +-+-+-+-+ + + +-+-+ +-+-+-+-+
|     |   | | | |   | |       |
+-+-+ + + + + +-+ + + + +-+-+ +
|   |   |   | |   |   | |     |
+ + +-+-+ + + + + +-+-+ + +-+ +
| |   |   | |   |     | |   | |
+ +-+ + +-+ +-+-+-+-+ + +-+ +-+
|   |   | |   |       | | |   |
+-+ +-+-+ +-+-+ +-+-+-+ + +-+ +
| | |   |     |   |     |     |
+ + + + + +-+ +-+ + +-+-+-+-+ +
| | | | |   |     | |   |     |
+ + +-+ +-+ +-+-+-+-+ + + + +-+
| |   |   |           |   |   |
+ + + +-+ +-+-+-+-+-+ + +-+-+-+
| | | |   |     |     |       |
+ + + + +-+ +-+ + +-+-+-+-+-+ +
|   |   |   |   | |           |
+-+-+-+-+ +-+ +-+ + +-+-+-+-+-+
| |     | |   |   | |   |     |
+ + + +-+ +-+-+ + + + + + +-+ +
|   |           | |   |   |   E
+-+-+-+-+-+-+-+-+-+-+-+-+-+-+-+