+-+-+-+-+-+-+-+-+-+-+-+-+-+-+-+
S     | |   |         |       |
+-+-+ + + +-+ +-+-+ +-+ +-+-+ +
|       |     | |     | |     |
+ +-+-+-+-+-+-+ + +-+ + + +-+-+
| |   |   |     | |   | | |   |
+ + + + + +-+-+ + + +-+-+ + + +
| | |   |   | |   |     |   | |
+ + +-+-+-+ + +-+-+-+-+ +-+ + +
|   |   |     |     |   |   | |
+-+ + + + +-+-+ +-+ + +-+ +-+-+
|   | | |       |   | |   |   |
+ +-+ + +-+-+-+ + +-+ + +-+-+ +
| |   |   |     | |   |     | |
+ +-+ + +-+ +-+-+-+ +-+-+ + + +
| |   |   |   |   | |     |   |
+ + +-+-+ +-+ + + + + +-+-+ +-+
|   |   |   |   |     |   |   |
+-+-+ +-+-+ +-+-+-+ +-+ +-+-+ +
|           |     |   |       |
+ +-+-+-+-+-+ +-+ +-+ + +-+-+ +
|     |       |   |   |   |   |
+-+-+ + +-+-+-+ +-+ +-+-+ +-+-+
|   |   |     | |       |   | |
+ +-+-+-+ +-+-+ + +-+-+-+-+ + +
| |             |       | |   |
+ + +-+ +-+-+-+-+-+ +-+ + +-+ +
| | |   | |       | | | |     |
+ + + +-+ + +-+-+ + + + + + +-+
|   |     |     |   |   | |   E
+-+-+-+-+-+-+-+-+-+-+-+-+-+-+-+