+-+-+-+-+-+-+-+-+-+-+-+-+-+-+-+
S |     |   |       |         |
+ + +-+ + + + +-+-+ +-+ +-+-+ +
| | |   | |   |   |   |     | |
+ + + +-+ +-+-+ + +-+ +-+-+-+ +
|   |     |     |     |     | |
+-+-+-+-+-+ +-+-+ +-+-+ +-+ + +
| |     |   |   | |   |   | | |
+ + +-+-+ +-+ + + + + +-+ + + +
| |       |   | | | | | | | | |
+ +-+-+-+-+ +-+-+ + + + + + + +
|     |         | | |   | | | |
+ +-+-+ +-+ +-+ + + + + +-+ + +
|     | | |   |   | | | |     |
+-+-+ + + +-+ +-+-+ + + + +-+-+
|   |   |     |     | | |   | |
+ + +-+ +-+-+-+ +-+-+-+ +-+ + +
| |   | |     |   |     | | | |
+ +-+ + + + + +-+-+ +-+-+ + + +
|   |   | | |     |         | |
+-+ +-+-+ + + +-+ +-+ +-+-+-+ +
| | |   | | | |   | |   |   | |
+ + + + + + + + +-+ +-+ + + + +
| |   |   | | | |     | | |   |
+ +-+-+-+-+ + + + + + + +-+ +-+
|       |   | |   | | |   |   |
+ +-+-+ +-+-+ +-+-+ + +-+ +-+ +
| |   |   |   |     |   |     |
+ + + +-+ +-+-+ +-+ + + + +-+-+
|   |   |       |   | |       E
+-+-+-+-+-+-+-+-+-+-+-+-+-+-+-+