+-+-+-+-+-+-+-+-+-+-+-+-+-+-+-+
S   |     |   |       |       |
+-+ + +-+ + + + +-+-+ + +-+-+ +
| | | |   | | |     |   |   | |
+ + + + +-+ + +-+-+-+-+-+ + + +
| |   | |   | |       |   |   |
+ + +-+ + +-+ + +-+ + + +-+-+-+
|   |   | |   | |   | |   |   |
+-+-+ +-+ + +-+ + +-+-+-+ + + +
|   | |   |   | |   |     | | |
+-+ + + +-+-+-+ +-+ + +-+-+-+ +
|   | |   |   | |   | |     | |
+ +-+ +-+ + + + + +-+ + + + + +
|       | | | | | | |   | | | |
+ +-+-+ + + + + + + +-+-+-+ + +
| | |       | | | |   |   | | |
+ + + +-+-+-+-+ + + + + + + + +
|   |           | | |   |   | |
+-+-+-+-+-+-+-+-+ +-+ + +-+-+ +
| |   |     |   |   | |   | | |
+ + + + +-+ +-+ +-+ + +-+ + + +
|   | | | |         | |   |   |
+ +-+ + + +-+-+-+ +-+-+ +-+ +-+
|   |   |     |       | |   | |
+-+ +-+ +-+-+ + +-+-+ + + +-+ +
|     |   |   | |   | | | |   |
+ +-+-+-+-+ + + + + + + + + +-+
| |   |     | |   | |     |   |
+ + + + +-+-+-+-+-+ +-+ + + + +
|   |   |           |   |   | E
+-+-+-+-+-+-+-+-+-+-+-+-+-+-+-+