+-+-+-+-+-+-+-+-+-+-+-+-+-+-+-+
S     |   |   |   |       |   |
+ +-+ +-+ + + + + + +-+-+ +-+ +
|   |     | | | | |   |   |   |
+-+ +-+-+-+ + +-+ + +-+ +-+ +-+
| |     |   |   | |   | |   | |
+ +-+ + + +-+-+ + +-+ + + +-+ +
|     |       | |   | |   |   |
+-+-+-+-+-+-+-+ +-+ + +-+-+-+ +
|     |         | |       |   |
+ +-+ + +-+-+-+-+ +-+-+ +-+ + +
| |   | |     |       | |   | |
+ + + + + +-+ + + +-+ + + +-+ +
| | | | | |   | |   |     |   |
+ +-+ + + + +-+-+-+ +-+-+-+ +-+
|   |   | | |     | |     |   |
+ + +-+-+ + + +-+ + + +-+ +-+ +
| |   |   |   |   |   | | |   |
+ +-+-+ +-+-+-+ +-+-+-+ + + +-+
|   |   |       |         | | |
+-+ + +-+ +-+-+-+ +-+-+-+-+ + +
|   | | |   |   |     |     | |
+ +-+ + + +-+ + +-+-+ + +-+-+ +
| |   |       |     | | |     |
+ +-+ +-+ +-+-+-+-+ + + + + +-+
|     |   |       |   |   | | |
+-+-+-+ +-+ +-+-+ +-+-+-+-+ + +
| |     |   |   |   |         |
+ + + +-+ +-+ + +-+ +-+-+-+ +-+
|   |   |     |   |           E
+-+-+-+-+-+-+-+-+-+-+-+-+-+-+-+